################################################################################################################
#                                                                                                              #
#                                A                                                                             #
#                                                                                                              #
#                                                                                                              #
#                                                                                                              #
########################################            #########################################         ##########
#                                       #          #                                       #                   #
#                                       #          #                                       #            C      #
#                                       #          #                                       #                   #
#                                       #          #                                       #                   #
#                                       #          #                                       #                   #
#                                       #          #                                       #                   #
#                                       #          #                                       #                   #
#                                       #          #                                       #                   #
#                                       #          #########################################         ###########
#                       #              #                                                              #
#       T               #                                                                              #
#                       #                                                                              #
#                       #                                                                      #################
#                       #              #                                                    #######            #
#######################################                                                      #                 #
#                                                                                             #                #
#                                                                                             #    B           #
#                                                                                             #                #
#                                                                                                    #         #
#                                                                                                    #         #
#                                                                                                    ###########
#                                                                                                              #
################################################################################################################
